2 1 # * 0 * 0 
4 3 3 * 2 # # 
3 5 # 1 4 1 # 
* * 2 1 * 2 3 
# 1 * 3 4 5 1 
* # * 4 2 * 4 
# # # # 1 4 # 
