0 0 # * 0 * 0 
0 0 0 * 0 # # 
0 0 # 0 2 0 # 
* * 0 0 * 1 3 
# 0 * 0 1 5 1 
* # * 4 2 * 4 
# # # # 1 4 # 
