# # # * 1 * 1 
# # 2 * 5 # # 
3 4 # 0 3 0 # 
* * 0 1 * 1 2 
# 0 * 3 4 5 0 
* # * 3 2 * 3 
# # # # 0 4 # 
