# # 2 # 4 * 1 
3 5 # 3 3 * 3 
* 3 5 1 2 * * 
* 3 # 4 * * 1 
# # * 5 * 4 4 
# # 2 * # * 2 
4 * 4 1 * # # 
