* * 3 1 * 4 # 
* 4 2 1 1 # 5 
2 3 1 * 1 3 3 
4 5 2 # * 4 4 
* 2 2 4 3 # 1 
2 # 4 2 1 * 4 
2 3 5 * 4 2 4 
