7 7 1
# # # * 1 * 1 
# # 4 * 5 # # 
3 5 # 2 4 1 # 
* * 2 1 * 2 3 
# 1 * 3 4 5 1 
* # * 4 2 * 4 
# # # # 1 4 # 
